{
  "numX": 13,
  "numY": 9,
  "tileNames": [
    "",
    "ProtoCoin",
    "ProtoBox",
	"Tile01",
	"ProtoBat"
  ],
  "start": [
    32,
    32
  ],
  "size": [
    64,
    64
  ],
  "tiles": [0, 0, 0, 0, 0, 0, 0, 0, 0, 0, 0, 0, 0,
            0, 4, 0, 0, 0, 0, 0, 0, 0, 0, 0, 4, 0,
            0, 0, 1, 0, 0, 0, 1, 0, 0, 0, 1, 0, 0,
            1, 0, 0, 0, 1, 0, 0, 0, 1, 0, 0, 0, 1,
            0, 0, 1, 0, 0, 0, 1, 0, 0, 0, 1, 0, 0,
            0, 0, 0, 0, 0, 0, 0, 0, 0, 0, 0, 0, 0,
            0, 0, 2, 0, 0, 0, 0, 0, 0, 0, 2, 0, 0,
            0, 0, 2, 0, 0, 0, 0, 0, 0, 0, 2, 0, 0,
            3, 3, 3, 3, 3, 3, 3, 3, 3, 3, 3, 3, 3]
}